█████████████████████████████
█           █               █
█  $        █               |
█           ████████        █
█       █                   █
█       █           B       █
█   H   █                   █
█████████████████████████████